5
3 6 -3
8 2 -10
8 4 -10
9 2 -10
9 19 -10
xxxxxxxxxxxxxxxxxxx xx
x                    x
x                    x
x     +              x
x                    x
x                    x
x                    x
x                    x
x + +          S     x
x +                + x
xxxxxxxxxxxxxxxxxxxxxx