2
3 6 -3
5 14 -1
xxxxxxxxxxxxxxxxxxxxxx
   xxx               x
x      xx            x
x    x+              x
x     xxx            x
x             +      x
x                    x
x                    x
x              S     x
x                    x
xxxxxxxxxxxxxxxxxxxxxx