2
3 6 -3
5 14 -1
xxxxxxxx xxxxxxxxxxxxx
x                    x
x                    x
x     +              x
x                    x
x             +      x
x                    x
x                    x
x              S     x
x                    x
xxxxxxxxxxxxxxxxxxxxxx